# ## # E   ### #    
# #        E #  ##  
#      E  # #      #
#     ##     P# #   
 P   # ####         
#E # # # S#    ## ##
    E### E E#  ##   
      # #  #  ##E  #
#  P ###  G P E# #  
  ### #    E# # # # 
