 E#    E   # #   ## 
  #  # #S #   #     
 #E##  ## ##  #  ## 
   # ##E #  # #     
#   #####  ##    #  
  ###   P      #    
##P   #  #E  #     #
  #   ## E#   #E   #
   #  GP    #      E
E #   # #E # # ###  
