  # #  #   # # # # #
  #   #    #EP G   #
 ##   # P #  #P#    
# ##  ## #   ###    
#P#       E#P#      
#  ##E E##E  ##  E #
# E# # #P## E  P  P 
## #  S  #   #  #   
  #    #      ##  E 
      ##      # E   
