      E#         #E 
    ###   #  #  # ##
 ##      P # #  P  #
  ###  #    #  P# E#
#  #  # #  # P  ##  
       E # # ##  E# 
 E###   ##       S #
   ##  #      ##   #
####    #  # #  G# #
 #    #     E #    #
