#E#    #     ###  # 
  ###  #        # # 
    ###   #E #  ####
    E   ##     #P  E
##  S#  #E# ##P##  #
 # #    E   #    G  
  E   #   # ####### 
 #   # #            
      #  #  #E# ## #
# #    #   ##   #   
