  #     # ## #  ## #
  E#  #   #   #  #  
     ## ### # E# #  
  ###    # ### #  # 
##   #  # E       ##
   E       # P #   #
#   E# #  #  # #P#  
    G E   # # # ##  
#  S  ## ## #   #  #
  # ###  ###   ##  #
