 #   # # #  ###   ##
#P# ##  E  ##       
#  ##  ##     #     
# #    #  ##   #    
# #   # #  #   S#  #
    E # # #         
  # E    #   ### ## 
E   #     #   ##   E
E E  # #  G  ##   # 
  # ###      ## E#  
