  ## #  #  E   # ## 
   #          EG  P 
   P     #  P       
   ##  E# #    #   #
  # ## ### E S   # E
 # ## P#            
  #  # # # #  E # #E
 #  #  E # #    ## #
  P#### ##    ##    
##   #    ###   #E  
