  #     #      #    
   #     ##  P     #
#P   #P   #P   #   #
#  E# #E #     ## S 
#   # #  #P         
#   #  # E #  # # # 
#    #    G   E# #  
   #  P  # # #  # # 
 #P  # ### # # #    
    #  #   E####    
