# ##    #          #
 # # #  #  #  ## # E
  #P#            #  
 # #E     # ##    ##
    # #  ### #    # 
  #  P  #P# # #  ## 
   ##E# # #  #  # G#
# #       # #S      
   #  ##  #   P  #  
    # ##     ##  #  
