#    # ##  ##       
    #EE  # #  ####  
 # ###E S#   ##     
  ###   ### # ###  #
   ##   #P   # # #G 
## #        ### #   
  #  P#E    # #     
## # E# #     # #   
 #E  E  #    #  ##  
#     #  # # ##     
