   ##E     #     # #
 ##  # ## # E  #    
 #     E   E ##   # 
# #G  ####  P# #    
 ##  #    E #   #   
# ##  P  ###S#   #  
  # # ## #P #    ###
##        #  #    # 
###P    ##  # E E # 
 #  #  ## # #       
