####   ##E   #   # E
  ###  #  # # #  ## 
# ## # #   #    P   
#   # #  PE##     # 
  S P# ### ##       
   ## #    ###   # E
# #  # PPE###    #  
## P E#   #      E# 
  #  #    ##  G# #  
 E       ## ###  #  
