##   # #           #
## #   G       P    
#  ##           E#  
   ###E# E   ##     
E         ####  # # 
# ##E#  ## ###    # 
   #    #     #     
   SE  ##  # ##  # #
 #P  ###       #  ##
 #   ## #  #   ## # 
