# ##  ## E    #  ## 
    ##  #  P # ##   
  #     ## ####   # 
 PPP ##     ## ##   
 ## #       # # #  #
 #   #  #   # G#  # 
#  # ## S      # P #
#   #    #E#    ### 
 # # #E#   # ##   E#
  ##   ##  #E       
