#       ####        
  #       # # ### # 
#    P   EE#     #  
#G #    #   E#P#    
 # P#S##    #       
  ###  # E#   # ## #
  ### # ##  ##   ###
       #  #  #   #  
  ##P #     # ###   
 ##  #       #      
