 ## #E ##E# # # EE #
  ## E              
##    # #P   # # # #
 E #   ####     #P #
 G  E#    #         
       P    #E  P # 
 #E          #### # 
 # # E###           
####ES    ## E  #   
#  #   ##### ### ###
