 E#E   # #   E#   # 
    #  ##  #  E   P 
  #      E # ###    
#     #  #   P#  #  
#            E # ## 
 ##SP   G#     # #  
   #  #         # ##
    ## #      # #   
     E#      #E #   
  ##  ##            
